Afghanistan|Afghanistan
Albania|Albanie
Algeria|Algérie
AmericanSamoa|--
Andorra|Andorre
Angola|Angola
Anguilla|--
Antarctica|--
AntiguaAndBarbuda|--
Argentina|Argentine
Armenia|Arménie
Aruba|--
Australia|Australie
Austria|Autriche
Azerbaijan|Azerbaïdjan
Bahamas|Bahamas
Bahrain|Bahreïn
Bangladesh|Bangladesh
Barbados|--
Belarus|Belarus
Belgium|Belgique
Belize|Belize
Benin|Benin
Bermuda|--
Bhutan|Bhoutan
Bolivia|Bolivie
BosniaAndHerzegowina|Bosnie
Botswana|Botswana
BouvetIsland|--
Brazil|Brésil
BritishIndianOceanTerritory|--
BruneiDarussalam|Brunei
Bulgaria|Bulgarie
BurkinaFaso|Burkina Faso
Burundi|Burundi
Cambodia|Cambodge
Cameroon|Cameroun
Canada|Canada
CapeVerde|Cap-Vert
CaymanIslands|--
CentralAfricanRepublic|Central African Rep
Chad|Tchad
Chile|Chili
China|Chine
ChristmasIsland|--
CocosIslands|--
Colombia|Colombie
Comoros|--
DemocraticRepublicOfCongo|Zaïre
PeoplesRepublicOfCongo|Congo
CookIslands|--
CostaRica|Costa Rica
IvoryCoast|Côte d'Ivoire
Croatia|Croatie
Cuba|Cuba
Cyprus|Chypre
CzechRepublic|République Tchèque
Denmark|Danemark
Djibouti|Djibouti
Dominica|--
DominicanRepublic|Dominican Rep.
EastTimor|--
Ecuador|Equateur
Egypt|Égypte
ElSalvador|El Salvador
EquatorialGuinea|Guinée équatoriale
Eritrea|--
Estonia|Estonie
Ethiopia|Ethiopie
FalklandIslands|--
FaroeIslands|--
Fiji|--
Finland|Finlande
France|France
MetropolitanFrance|France
FrenchGuiana|Guyane française
FrenchPolynesia|--
FrenchSouthernTerritories|--
Gabon|Gabon
Gambia|Gambie
Georgia|Georgie
Germany|Allemagne
Ghana|Ghana
Gibraltar|Gibraltar
Greece|Grèce
Greenland|Groënland
Grenada|--
Guadeloupe|Guadeloupe
Guam|--
Guatemala|Guatemala
Guinea|Guinée
GuineaBissau|Guinée-Bissau
Guyana|Guyana
Haiti|Haiti
HeardAndMcDonaldIslands|--
Honduras|Honduras
HongKong|--
Hungary|Hongrie
Iceland|Islande
India|Inde
Indonesia|Indonesie
Iran|Iran
Iraq|Iraq
Ireland|Irlande
Israel|Israel
Italy|Italie
Jamaica|Jamaïque
Japan|Japon
Jordan|Jordanie
Kazakhstan|Kazakhstan
Kenya|Kenya
Kiribati|--
DemocraticRepublicOfKorea|Corée du Nord
RepublicOfKorea|Corée du Sud
Kuwait|Koweït
Kyrgyzstan|Kirghizistan
Lao|Laos
Latvia|Lettonie
Lebanon|Liban
Lesotho|Lesotho
Liberia|Liberia
LibyanArabJamahiriya|Libye
Liechtenstein|Liechtenstein
Lithuania|Lituanie
Luxembourg|Luxembourg
Macau|Macao
Macedonia|Macédoine
Madagascar|Madagascar
Malawi|Malawi
Malaysia|Malaisie
Maldives|--
Mali|Mali
Malta|Malte
MarshallIslands|--
Martinique|Martinique
Mauritania|Mauritanie
Mauritius|--
Mayotte|--
Mexico|Mexique
Micronesia|--
Moldova|Moldavie
Monaco|Monaco
Mongolia|Mongolie
Montserrat|--
Morocco|Maroc
Mozambique|Mozambique
Myanmar|Birmanie
Namibia|Namibie
Nauru|--
Nepal|Nepal
Netherlands|Pays-Bas
NetherlandsAntilles|--
NewCaledonia|Nouvelle-Calédonie (France)
NewZealand|Nouvelle-Zélande
Nicaragua|Nicaragua
Niger|Niger
Nigeria|Nigeria
Niue|--
NorfolkIsland|--
NorthernMarianaIslands|--
Norway|Norvège
Oman|Oman
Pakistan|Pakistan
Palau|--
PalestinianTerritory|--
Panama|Panama
PapuaNewGuinea|Papouasie-Nouvelle-Guinée
Paraguay|Paraguay
Peru|Pérou
Philippines|Philippines
Pitcairn|--
Poland|Pologne
Portugal|Portugal
PuertoRico|--
Qatar|Qatar
Reunion|France - Réunion
Romania|Roumanie
RussianFederation|Russie
Rwanda|Rwanda
SaintKittsAndNevis|--
StLucia|--
StVincentAndTheGrenadines|--
Samoa|--
SanMarino|--
SaoTomeAndPrincipe|Sao Tomé-et-Principe
SaudiArabia|Arabie Saoudite
Senegal|Sénégal
Seychelles|--
SierraLeone|Sierra Leone
Singapore|Singapour
Slovakia|Slovaquie
Slovenia|Slovenie
SolomonIslands|--
Somalia|Somalie
SouthAfrica|Afrique du Sud
SouthGeorgiaAndTheSouthSandwichIslands|--
Spain|Espagne
SriLanka|Sri Lanka
StHelena|--
StPierreAndMiquelon|Saint-Pierre et Miquelon (France)
Sudan|Soudan
Suriname|Surinam
SvalbardAndJanMayenIslands|--
Swaziland|Swaziland
Sweden|Suède
Switzerland|Suisse
SyrianArabRepublic|Syrie
Taiwan|Taiwan
Tajikistan|Tadjikistan
Tanzania|Tanzanie
Thailand|Thaïlande
Togo|Togo
Tokelau|--
Tonga|--
TrinidadAndTobago|--
Tunisia|Tunisie
Turkey|Turquie
Turkmenistan|Turkménistan
TurksAndCaicosIslands|--
Tuvalu|--
Uganda|Ouganda
Ukraine|Ukraine
UnitedArabEmirates|Émirats arabes unis
UnitedKingdom|Royaume-Uni
UnitedStates|Etats-Unis
UnitedStatesMinorOutlyingIslands|--
Uruguay|Uruguay
Uzbekistan|Ouzbékistan
Vanuatu|--
VaticanCityState|Italie
Venezuela|Vénézuela
VietNam|Vietnam
BritishVirginIslands|--
USVirginIslands|--
WallisAndFutunaIslands|--
WesternSahara|--
Yemen|--
Yugoslavia|Yougoslavie
Zambia|Zambie
Zimbabwe|Zimbabwe